# 《國語注音符號手冊》“陸、國語音節表注音示例”（2000年11月書面版初版）
# 共1269个音节（忽略缺字的音节，无轻声）
#
# https://language.moe.gov.tw/001/Upload/files/site_content/M0001/juyin/index.html
#
# 其中部分存在读音问题参见备注说明：
# 濘	ㄋㄥˋ	
# 忸->沑	ㄋㄩˋ
# 舀->歪	ㄨㄞˇ
#
# 拼音	注音	例字	备注

zhī	ㄓ	之	
chī	ㄔ	蚩	
shī	ㄕ	尸	
zī	ㄗ	孜	
cī	ㄘ	雌	
sī	ㄙ	私	
zhí	ㄓˊ	直	
chí	ㄔˊ	池	
shí	ㄕˊ	時	
cí	ㄘˊ	祠	
zhǐ	ㄓˇ	止	
chǐ	ㄔˇ	恥	
shǐ	ㄕˇ	史	
zǐ	ㄗˇ	子	
cǐ	ㄘˇ	此	
sǐ	ㄙˇ	死	
zhì	ㄓˋ	志	
chì	ㄔˋ	翅	
shì	ㄕˋ	是	
rì	ㄖˋ	日	
zì	ㄗˋ	字	
cì	ㄘˋ	次	
sì	ㄙˋ	四	
bā	ㄅㄚ	巴	
pā	ㄆㄚ	趴	
mā	ㄇㄚ	媽	
fā	ㄈㄚ	發	
dā	ㄉㄚ	搭	
tā	ㄊㄚ	他	
nā	ㄋㄚ	那	
lā	ㄌㄚ	拉	
gā	ㄍㄚ	旮	
kā	ㄎㄚ	咖	
hā	ㄏㄚ	哈	
zhā	ㄓㄚ	扎	
chā	ㄔㄚ	叉	
shā	ㄕㄚ	沙	
zā	ㄗㄚ	紮	
cā	ㄘㄚ	擦	
sā	ㄙㄚ	撒	
ā	ㄚ	啊	
bá	ㄅㄚˊ	拔	
pá	ㄆㄚˊ	爬	
má	ㄇㄚˊ	麻	
fá	ㄈㄚˊ	乏	
dá	ㄉㄚˊ	答	
ná	ㄋㄚˊ	拿	
lá	ㄌㄚˊ	邋	
gá	ㄍㄚˊ	噶	
há	ㄏㄚˊ	蝦	
zhá	ㄓㄚˊ	紮	
chá	ㄔㄚˊ	茶	
shá	ㄕㄚˊ	啥	
zá	ㄗㄚˊ	咱	
á	ㄚˊ	嗄	
bǎ	ㄅㄚˇ	把	
mǎ	ㄇㄚˇ	馬	
fǎ	ㄈㄚˇ	髮	
dǎ	ㄉㄚˇ	打	
tǎ	ㄊㄚˇ	塔	
nǎ	ㄋㄚˇ	哪	
lǎ	ㄌㄚˇ	喇	
kǎ	ㄎㄚˇ	卡	
hǎ	ㄏㄚˇ	哈	
zhǎ	ㄓㄚˇ	眨	
shǎ	ㄕㄚˇ	傻	
cǎ	ㄘㄚˇ	礤	
sǎ	ㄙㄚˇ	灑	
bà	ㄅㄚˋ	爸	
pà	ㄆㄚˋ	怕	
mà	ㄇㄚˋ	罵	
fà	ㄈㄚˋ	琺	
dà	ㄉㄚˋ	大	
tà	ㄊㄚˋ	沓	
nà	ㄋㄚˋ	那	
là	ㄌㄚˋ	辣	
gà	ㄍㄚˋ	尬	
kà	ㄎㄚˋ	喀	
zhà	ㄓㄚˋ	乍	
chà	ㄔㄚˋ	岔	
shà	ㄕㄚˋ	煞	
sà	ㄙㄚˋ	薩	
à	ㄚˋ	阿	
bō	ㄅㄛ	玻	
pō	ㄆㄛ	坡	
mō	ㄇㄛ	摸	
lō	ㄌㄛ	*咯	輕聲變韻
ō	ㄛ	喔	
bó	ㄅㄛˊ	柏	
pó	ㄆㄛˊ	婆	
mó	ㄇㄛˊ	模	
fó	ㄈㄛˊ	佛	
ó	ㄛˊ	哦	
bǒ	ㄅㄛˇ	跛	
pǒ	ㄆㄛˇ	叵	
mǒ	ㄇㄛˇ	抹	
ǒ	ㄛˇ	嚄	
bò	ㄅㄛˋ	播	
pò	ㄆㄛˋ	破	
mò	ㄇㄛˋ	末	
mē	ㄇㄜ	*麼	輕聲變韻
gē	ㄍㄜ	哥	
kē	ㄎㄜ	科	
hē	ㄏㄜ	訶	
zhē	ㄓㄜ	遮	
chē	ㄔㄜ	車	
shē	ㄕㄜ	奢	
ē	ㄜ	痾	
dé	ㄉㄜˊ	德	
gé	ㄍㄜˊ	閣	
ké	ㄎㄜˊ	咳	
hé	ㄏㄜˊ	禾	
zhé	ㄓㄜˊ	蜇	
shé	ㄕㄜˊ	蛇	
zé	ㄗㄜˊ	則	
é	ㄜˊ	娥	
gě	ㄍㄜˇ	葛	
kě	ㄎㄜˇ	可	
zhě	ㄓㄜˇ	者	
chě	ㄔㄜˇ	扯	
shě	ㄕㄜˇ	捨	
rě	ㄖㄜˇ	惹	
zě	ㄗㄜˇ	怎	
ě	ㄜˇ	噁	
tè	ㄊㄜˋ	特	
nè	ㄋㄜˋ	訥	
lè	ㄌㄜˋ	肋	
gè	ㄍㄜˋ	各	
kè	ㄎㄜˋ	課	
hè	ㄏㄜˋ	賀	
zhè	ㄓㄜˋ	這	
chè	ㄔㄜˋ	澈	
shè	ㄕㄜˋ	射	
rè	ㄖㄜˋ	熱	
zè	ㄗㄜˋ	仄	
cè	ㄘㄜˋ	測	
sè	ㄙㄜˋ	色	
è	ㄜˋ	餓	
ề	ㄝˋ	誒	
bāi	ㄅㄞ	掰	
pāi	ㄆㄞ	拍	
dāi	ㄉㄞ	呆	
tāi	ㄊㄞ	胎	
gāi	ㄍㄞ	該	
kāi	ㄎㄞ	開	
hāi	ㄏㄞ	咳	
zhāi	ㄓㄞ	摘	
chāi	ㄔㄞ	拆	
shāi	ㄕㄞ	篩	
zāi	ㄗㄞ	災	
cāi	ㄘㄞ	猜	
sāi	ㄙㄞ	腮	
āi	ㄞ	哀	
bái	ㄅㄞˊ	白	
pái	ㄆㄞˊ	排	
mái	ㄇㄞˊ	埋	
tái	ㄊㄞˊ	臺	
lái	ㄌㄞˊ	來	
hái	ㄏㄞˊ	孩	
zhái	ㄓㄞˊ	宅	
chái	ㄔㄞˊ	柴	
cái	ㄘㄞˊ	才	
ái	ㄞˊ	皚	
bǎi	ㄅㄞˇ	擺	
pǎi	ㄆㄞˇ	排	
mǎi	ㄇㄞˇ	買	
dǎi	ㄉㄞˇ	歹	
nǎi	ㄋㄞˇ	乃	
gǎi	ㄍㄞˇ	改	
kǎi	ㄎㄞˇ	楷	
hǎi	ㄏㄞˇ	海	
zhǎi	ㄓㄞˇ	窄	
shǎi	ㄕㄞˇ	色	
zǎi	ㄗㄞˇ	宰	
cǎi	ㄘㄞˇ	采	
ǎi	ㄞˇ	藹	
bài	ㄅㄞˋ	敗	
pài	ㄆㄞˋ	派	
mài	ㄇㄞˋ	賣	
dài	ㄉㄞˋ	代	
tài	ㄊㄞˋ	太	
nài	ㄋㄞˋ	奈	
lài	ㄌㄞˋ	賴	
gài	ㄍㄞˋ	丐	
kài	ㄎㄞˋ	愾	
hài	ㄏㄞˋ	害	
zhài	ㄓㄞˋ	債	
chài	ㄔㄞˋ	瘥	
shài	ㄕㄞˋ	晒	
zài	ㄗㄞˋ	再	
cài	ㄘㄞˋ	菜	
sài	ㄙㄞˋ	賽	
ài	ㄞˋ	愛	
bēi	ㄅㄟ	卑	
pēi	ㄆㄟ	胚	
fēi	ㄈㄟ	非	
lēi	ㄌㄟ	勒	
hēi	ㄏㄟ	黑	
péi	ㄆㄟˊ	培	
méi	ㄇㄟˊ	眉	
féi	ㄈㄟˊ	肥	
léi	ㄌㄟˊ	雷	
shéi	ㄕㄟˊ	誰	
zéi	ㄗㄟˊ	賊	
běi	ㄅㄟˇ	北	
měi	ㄇㄟˇ	美	
fěi	ㄈㄟˇ	匪	
děi	ㄉㄟˇ	得	
něi	ㄋㄟˇ	餒	
lěi	ㄌㄟˇ	蕾	
gěi	ㄍㄟˇ	給	
hěi	ㄏㄟˇ	黑	
bèi	ㄅㄟˋ	貝	
pèi	ㄆㄟˋ	配	
mèi	ㄇㄟˋ	妹	
fèi	ㄈㄟˋ	肺	
nèi	ㄋㄟˋ	內	
lèi	ㄌㄟˋ	類	
zhèi	ㄓㄟˋ	這	
èi	ㄟˋ	欸	
bāo	ㄅㄠ	包	
pāo	ㄆㄠ	拋	
māo	ㄇㄠ	貓	
dāo	ㄉㄠ	刀	
tāo	ㄊㄠ	滔	
lāo	ㄌㄠ	撈	
gāo	ㄍㄠ	羔	
kāo	ㄎㄠ	尻	
hāo	ㄏㄠ	蒿	
zhāo	ㄓㄠ	招	
chāo	ㄔㄠ	抄	
shāo	ㄕㄠ	稍	
zāo	ㄗㄠ	糟	
cāo	ㄘㄠ	操	
sāo	ㄙㄠ	搔	
āo	ㄠ	凹	
báo	ㄅㄠˊ	薄	
páo	ㄆㄠˊ	袍	
máo	ㄇㄠˊ	毛	
táo	ㄊㄠˊ	桃	
náo	ㄋㄠˊ	撓	
láo	ㄌㄠˊ	勞	
háo	ㄏㄠˊ	豪	
zháo	ㄓㄠˊ	著	
cháo	ㄔㄠˊ	朝	
sháo	ㄕㄠˊ	勺	
ráo	ㄖㄠˊ	饒	
záo	ㄗㄠˊ	鑿	
cáo	ㄘㄠˊ	曹	
áo	ㄠˊ	敖	
bǎo	ㄅㄠˇ	保	
pǎo	ㄆㄠˇ	跑	
mǎo	ㄇㄠˇ	卯	
dǎo	ㄉㄠˇ	倒	
tǎo	ㄊㄠˇ	討	
nǎo	ㄋㄠˇ	腦	
lǎo	ㄌㄠˇ	老	
gǎo	ㄍㄠˇ	稿	
kǎo	ㄎㄠˇ	考	
hǎo	ㄏㄠˇ	好	
zhǎo	ㄓㄠˇ	找	
chǎo	ㄔㄠˇ	吵	
shǎo	ㄕㄠˇ	少	
rǎo	ㄖㄠˇ	擾	
zǎo	ㄗㄠˇ	早	
cǎo	ㄘㄠˇ	草	
sǎo	ㄙㄠˇ	掃	
ǎo	ㄠˇ	襖	
bào	ㄅㄠˋ	抱	
pào	ㄆㄠˋ	砲	
mào	ㄇㄠˋ	帽	
dào	ㄉㄠˋ	到	
tào	ㄊㄠˋ	套	
nào	ㄋㄠˋ	鬧	
lào	ㄌㄠˋ	澇	
gào	ㄍㄠˋ	告	
kào	ㄎㄠˋ	靠	
hào	ㄏㄠˋ	浩	
zhào	ㄓㄠˋ	召	
shào	ㄕㄠˋ	紹	
rào	ㄖㄠˋ	繞	
zào	ㄗㄠˋ	造	
cào	ㄘㄠˋ	肏	
sào	ㄙㄠˋ	臊	
ào	ㄠˋ	傲	
pōu	ㄆㄡ	剖	
dōu	ㄉㄡ	都	
tōu	ㄊㄡ	偷	
lōu	ㄌㄡ	摟	
gōu	ㄍㄡ	勾	
kōu	ㄎㄡ	摳	
hōu	ㄏㄡ	齁	
zhōu	ㄓㄡ	州	
chōu	ㄔㄡ	抽	
shōu	ㄕㄡ	收	
zōu	ㄗㄡ	鄒	
sōu	ㄙㄡ	搜	
ōu	ㄡ	歐	
póu	ㄆㄡˊ	抔	
móu	ㄇㄡˊ	謀	
fóu	ㄈㄡˊ	芣	
tóu	ㄊㄡˊ	頭	
lóu	ㄌㄡˊ	樓	
hóu	ㄏㄡˊ	侯	
zhóu	ㄓㄡˊ	軸	
chóu	ㄔㄡˊ	酬	
shóu	ㄕㄡˊ	熟	
róu	ㄖㄡˊ	柔	
pǒu	ㄆㄡˇ	剖	
mǒu	ㄇㄡˇ	某	
fǒu	ㄈㄡˇ	否	
dǒu	ㄉㄡˇ	斗	
tǒu	ㄊㄡˇ	黈	
lǒu	ㄌㄡˇ	簍	
gǒu	ㄍㄡˇ	狗	
kǒu	ㄎㄡˇ	口	
hǒu	ㄏㄡˇ	吼	
zhǒu	ㄓㄡˇ	帚	
chǒu	ㄔㄡˇ	醜	
shǒu	ㄕㄡˇ	手	
rǒu	ㄖㄡˇ	糅	
zǒu	ㄗㄡˇ	走	
sǒu	ㄙㄡˇ	叟	
ǒu	ㄡˇ	偶	
mòu	ㄇㄡˋ	瞀	
fòu	ㄈㄡˋ	復	
dòu	ㄉㄡˋ	豆	
tòu	ㄊㄡˋ	透	
nòu	ㄋㄡˋ	耨	
lòu	ㄌㄡˋ	漏	
gòu	ㄍㄡˋ	夠	
kòu	ㄎㄡˋ	扣	
hòu	ㄏㄡˋ	后	
zhòu	ㄓㄡˋ	紂	
chòu	ㄔㄡˋ	臭	
shòu	ㄕㄡˋ	受	
ròu	ㄖㄡˋ	肉	
zòu	ㄗㄡˋ	奏	
còu	ㄘㄡˋ	湊	
sòu	ㄙㄡˋ	嗽	
òu	ㄡˋ	慪	
bān	ㄅㄢ	般	
pān	ㄆㄢ	潘	
mān	ㄇㄢ	顢	
fān	ㄈㄢ	番	
dān	ㄉㄢ	單	
tān	ㄊㄢ	攤	
nān	ㄋㄢ	囡	
gān	ㄍㄢ	干	
kān	ㄎㄢ	刊	
hān	ㄏㄢ	憨	
zhān	ㄓㄢ	占	
chān	ㄔㄢ	攙	
shān	ㄕㄢ	山	
zān	ㄗㄢ	簪	
cān	ㄘㄢ	參	
sān	ㄙㄢ	三	
ān	ㄢ	安	
pán	ㄆㄢˊ	盤	
mán	ㄇㄢˊ	饅	
fán	ㄈㄢˊ	凡	
tán	ㄊㄢˊ	談	
nán	ㄋㄢˊ	南	
lán	ㄌㄢˊ	蘭	
hán	ㄏㄢˊ	含	
chán	ㄔㄢˊ	蟬	
rán	ㄖㄢˊ	然	
zán	ㄗㄢˊ	咱	
cán	ㄘㄢˊ	殘	
bǎn	ㄅㄢˇ	板	
mǎn	ㄇㄢˇ	滿	
fǎn	ㄈㄢˇ	反	
dǎn	ㄉㄢˇ	膽	
tǎn	ㄊㄢˇ	毯	
nǎn	ㄋㄢˇ	赧	
lǎn	ㄌㄢˇ	懶	
gǎn	ㄍㄢˇ	趕	
kǎn	ㄎㄢˇ	砍	
hǎn	ㄏㄢˇ	罕	
zhǎn	ㄓㄢˇ	展	
chǎn	ㄔㄢˇ	產	
shǎn	ㄕㄢˇ	閃	
rǎn	ㄖㄢˇ	冉	
zǎn	ㄗㄢˇ	攢	
cǎn	ㄘㄢˇ	慘	
sǎn	ㄙㄢˇ	散	
ǎn	ㄢˇ	俺	
bàn	ㄅㄢˋ	半	
pàn	ㄆㄢˋ	判	
màn	ㄇㄢˋ	慢	
fàn	ㄈㄢˋ	飯	
dàn	ㄉㄢˋ	旦	
tàn	ㄊㄢˋ	探	
nàn	ㄋㄢˋ	難	
làn	ㄌㄢˋ	濫	
gàn	ㄍㄢˋ	幹	
kàn	ㄎㄢˋ	看	
hàn	ㄏㄢˋ	汗	
zhàn	ㄓㄢˋ	占	
chàn	ㄔㄢˋ	懺	
shàn	ㄕㄢˋ	扇	
zàn	ㄗㄢˋ	贊	
càn	ㄘㄢˋ	璨	
sàn	ㄙㄢˋ	散	
àn	ㄢˋ	岸	
bēn	ㄅㄣ	奔	
pēn	ㄆㄣ	噴	
mēn	ㄇㄣ	燜	
fēn	ㄈㄣ	分	
gēn	ㄍㄣ	根	
zhēn	ㄓㄣ	珍	
chēn	ㄔㄣ	嗔	
shēn	ㄕㄣ	申	
zēn	ㄗㄣ	簪	
cēn	ㄘㄣ	參	
sēn	ㄙㄣ	森	
ēn	ㄣ	恩	
pén	ㄆㄣˊ	盆	
mén	ㄇㄣˊ	門	
fén	ㄈㄣˊ	汾	
gén	ㄍㄣˊ	哏	
hén	ㄏㄣˊ	痕	
chén	ㄔㄣˊ	陳	
shén	ㄕㄣˊ	神	
rén	ㄖㄣˊ	人	
cén	ㄘㄣˊ	岑	
běn	ㄅㄣˇ	本	
fěn	ㄈㄣˇ	粉	
kěn	ㄎㄣˇ	肯	
hěn	ㄏㄣˇ	很	
zhěn	ㄓㄣˇ	枕	
chěn	ㄔㄣˇ	磣	
shěn	ㄕㄣˇ	審	
rěn	ㄖㄣˇ	忍	
zěn	ㄗㄣˇ	怎	
bèn	ㄅㄣˋ	笨	
pèn	ㄆㄣˋ	噴	
mèn	ㄇㄣˋ	悶	
fèn	ㄈㄣˋ	憤	
nèn	ㄋㄣˋ	嫩	
gèn	ㄍㄣˋ	艮	
kèn	ㄎㄣˋ	裉	
hèn	ㄏㄣˋ	恨	
zhèn	ㄓㄣˋ	振	
chèn	ㄔㄣˋ	趁	
shèn	ㄕㄣˋ	甚	
rèn	ㄖㄣˋ	刃	
zèn	ㄗㄣˋ	譖	
èn	ㄣˋ	摁	
bāng	ㄅㄤ	幫	
pāng	ㄆㄤ	乓	
fāng	ㄈㄤ	方	
dāng	ㄉㄤ	當	
tāng	ㄊㄤ	湯	
gāng	ㄍㄤ	岡	
kāng	ㄎㄤ	康	
hāng	ㄏㄤ	夯	
zhāng	ㄓㄤ	章	
chāng	ㄔㄤ	昌	
shāng	ㄕㄤ	傷	
zāng	ㄗㄤ	臧	
cāng	ㄘㄤ	倉	
sāng	ㄙㄤ	桑	
āng	ㄤ	腌	
páng	ㄆㄤˊ	旁	
máng	ㄇㄤˊ	忙	
fáng	ㄈㄤˊ	房	
táng	ㄊㄤˊ	唐	
náng	ㄋㄤˊ	囊	
láng	ㄌㄤˊ	狼	
káng	ㄎㄤˊ	扛	
háng	ㄏㄤˊ	杭	
cháng	ㄔㄤˊ	常	
ráng	ㄖㄤˊ	攘	
cáng	ㄘㄤˊ	藏	
áng	ㄤˊ	昂	
bǎng	ㄅㄤˇ	榜	
pǎng	ㄆㄤˇ	嗙	
mǎng	ㄇㄤˇ	莽	
fǎng	ㄈㄤˇ	仿	
dǎng	ㄉㄤˇ	黨	
tǎng	ㄊㄤˇ	倘	
nǎng	ㄋㄤˇ	曩	
lǎng	ㄌㄤˇ	朗	
gǎng	ㄍㄤˇ	港	
kǎng	ㄎㄤˇ	慷	
zhǎng	ㄓㄤˇ	長	
chǎng	ㄔㄤˇ	敞	
shǎng	ㄕㄤˇ	賞	
rǎng	ㄖㄤˇ	嚷	
zǎng	ㄗㄤˇ	駔	
cǎng	ㄘㄤˇ	駔	
sǎng	ㄙㄤˇ	嗓	
bàng	ㄅㄤˋ	棒	
pàng	ㄆㄤˋ	胖	
fàng	ㄈㄤˋ	放	
dàng	ㄉㄤˋ	蕩	
tàng	ㄊㄤˋ	燙	
nàng	ㄋㄤˋ	齉	
làng	ㄌㄤˋ	浪	
gàng	ㄍㄤˋ	槓	
kàng	ㄎㄤˋ	亢	
zhàng	ㄓㄤˋ	漲	
chàng	ㄔㄤˋ	唱	
shàng	ㄕㄤˋ	尚	
ràng	ㄖㄤˋ	讓	
zàng	ㄗㄤˋ	葬	
sàng	ㄙㄤˋ	喪	
àng	ㄤˋ	盎	
bēng	ㄅㄥ	崩	
pēng	ㄆㄥ	烹	
mēng	ㄇㄥ	矇	
fēng	ㄈㄥ	蜂	
dēng	ㄉㄥ	登	
gēng	ㄍㄥ	庚	
kēng	ㄎㄥ	硜	
hēng	ㄏㄥ	亨	
zhēng	ㄓㄥ	征	
chēng	ㄔㄥ	稱	
shēng	ㄕㄥ	升	
rēng	ㄖㄥ	扔	
zēng	ㄗㄥ	增	
cēng	ㄘㄥ	噌	
sēng	ㄙㄥ	僧	
ēng	ㄥ	鞥	
béng	ㄅㄥˊ	甭	
péng	ㄆㄥˊ	朋	
méng	ㄇㄥˊ	蒙	
féng	ㄈㄥˊ	馮	
téng	ㄊㄥˊ	疼	
néng	ㄋㄥˊ	能	
léng	ㄌㄥˊ	楞	
héng	ㄏㄥˊ	恆	
chéng	ㄔㄥˊ	成	
shéng	ㄕㄥˊ	繩	
réng	ㄖㄥˊ	仍	
céng	ㄘㄥˊ	曾	
běng	ㄅㄥˇ	繃	
pěng	ㄆㄥˇ	捧	
měng	ㄇㄥˇ	猛	
fěng	ㄈㄥˇ	唪	
děng	ㄉㄥˇ	等	
lěng	ㄌㄥˇ	冷	
gěng	ㄍㄥˇ	梗	
kěng	ㄎㄥˇ	肯	
zhěng	ㄓㄥˇ	整	
chěng	ㄔㄥˇ	逞	
shěng	ㄕㄥˇ	省	
rěng	ㄖㄥˇ	扔	
bèng	ㄅㄥˋ	蹦	
pèng	ㄆㄥˋ	碰	
mèng	ㄇㄥˋ	孟	
fèng	ㄈㄥˋ	奉	
dèng	ㄉㄥˋ	瞪	
nèng	ㄋㄥˋ	濘*	读音存疑
lèng	ㄌㄥˋ	愣	
gèng	ㄍㄥˋ	更	
hèng	ㄏㄥˋ	橫	
zhèng	ㄓㄥˋ	正	
chèng	ㄔㄥˋ	稱	
shèng	ㄕㄥˋ	勝	
zèng	ㄗㄥˋ	贈	
cèng	ㄘㄥˋ	蹭	
ér	ㄦˊ	兒	
ěr	ㄦˇ	耳	
èr	ㄦˋ	二	
bī	ㄅㄧ	逼	
pī	ㄆㄧ	批	
mī	ㄇㄧ	咪	
dī	ㄉㄧ	低	
tī	ㄊㄧ	梯	
lī	ㄌㄧ	哩	
jī	ㄐㄧ	肌	
qī	ㄑㄧ	欺	
xī	ㄒㄧ	希	
yī	ㄧ	衣	
bí	ㄅㄧˊ	鼻	
pí	ㄆㄧˊ	皮	
mí	ㄇㄧˊ	迷	
dí	ㄉㄧˊ	迪	
tí	ㄊㄧˊ	提	
ní	ㄋㄧˊ	尼	
lí	ㄌㄧˊ	離	
jí	ㄐㄧˊ	及	
qí	ㄑㄧˊ	其	
xí	ㄒㄧˊ	昔	
yí	ㄧˊ	移	
bǐ	ㄅㄧˇ	比	
pǐ	ㄆㄧˇ	否	
mǐ	ㄇㄧˇ	米	
dǐ	ㄉㄧˇ	底	
tǐ	ㄊㄧˇ	體	
nǐ	ㄋㄧˇ	你	
lǐ	ㄌㄧˇ	里	
jǐ	ㄐㄧˇ	己	
qǐ	ㄑㄧˇ	起	
xǐ	ㄒㄧˇ	喜	
yǐ	ㄧˇ	以	
bì	ㄅㄧˋ	泌	
pì	ㄆㄧˋ	屁	
mì	ㄇㄧˋ	祕	
dì	ㄉㄧˋ	帝	
tì	ㄊㄧˋ	悌	
nì	ㄋㄧˋ	逆	
lì	ㄌㄧˋ	利	
jì	ㄐㄧˋ	季	
qì	ㄑㄧˋ	氣	
xì	ㄒㄧˋ	系	
yì	ㄧˋ	易	
jiā	ㄐㄧㄚ	加	
qiā	ㄑㄧㄚ	掐	
xiā	ㄒㄧㄚ	蝦	
yā	ㄧㄚ	鴉	
jiá	ㄐㄧㄚˊ	夾	
xiá	ㄒㄧㄚˊ	挾	
yá	ㄧㄚˊ	牙	
liǎ	ㄌㄧㄚˇ	倆	
jiǎ	ㄐㄧㄚˇ	假	
qiǎ	ㄑㄧㄚˇ	卡	
yǎ	ㄧㄚˇ	啞	
jià	ㄐㄧㄚˋ	稼	
qià	ㄑㄧㄚˋ	恰	
xià	ㄒㄧㄚˋ	夏	
yà	ㄧㄚˋ	亞	
yō	ㄧㄛ	唷	
biē	ㄅㄧㄝ	鱉	
piē	ㄆㄧㄝ	瞥	
miē	ㄇㄧㄝ	乜	
diē	ㄉㄧㄝ	爹	
tiē	ㄊㄧㄝ	貼	
niē	ㄋㄧㄝ	捏	
liē	ㄌㄧㄝ	咧	
jiē	ㄐㄧㄝ	皆	
qiē	ㄑㄧㄝ	切	
xiē	ㄒㄧㄝ	些	
yē	ㄧㄝ	耶	
bié	ㄅㄧㄝˊ	別	
dié	ㄉㄧㄝˊ	碟	
nié	ㄋㄧㄝˊ	苶	
lié	ㄌㄧㄝˊ	咧	
jié	ㄐㄧㄝˊ	潔	
qié	ㄑㄧㄝˊ	茄	
xié	ㄒㄧㄝˊ	鞋	
yé	ㄧㄝˊ	爺	
biě	ㄅㄧㄝˇ	癟	
piě	ㄆㄧㄝˇ	撇	
tiě	ㄊㄧㄝˇ	鐵	
liě	ㄌㄧㄝˇ	咧	
jiě	ㄐㄧㄝˇ	解	
qiě	ㄑㄧㄝˇ	且	
xiě	ㄒㄧㄝˇ	寫	
yě	ㄧㄝˇ	也	
biè	ㄅㄧㄝˋ	彆	
miè	ㄇㄧㄝˋ	滅	
tiè	ㄊㄧㄝˋ	餮	
niè	ㄋㄧㄝˋ	孽	
liè	ㄌㄧㄝˋ	列	
jiè	ㄐㄧㄝˋ	介	
qiè	ㄑㄧㄝˋ	妾	
xiè	ㄒㄧㄝˋ	械	
yè	ㄧㄝˋ	夜	
yái	ㄧㄞˊ	崖	
biāo	ㄅㄧㄠ	標	
piāo	ㄆㄧㄠ	漂	
miāo	ㄇㄧㄠ	喵	
diāo	ㄉㄧㄠ	刁	
tiāo	ㄊㄧㄠ	挑	
liāo	ㄌㄧㄠ	撩	
jiāo	ㄐㄧㄠ	交	
qiāo	ㄑㄧㄠ	敲	
xiāo	ㄒㄧㄠ	削	
yāo	ㄧㄠ	夭	
piáo	ㄆㄧㄠˊ	瓢	
miáo	ㄇㄧㄠˊ	苗	
tiáo	ㄊㄧㄠˊ	條	
liáo	ㄌㄧㄠˊ	聊	
jiáo	ㄐㄧㄠˊ	嚼	
qiáo	ㄑㄧㄠˊ	喬	
yáo	ㄧㄠˊ	搖	
biǎo	ㄅㄧㄠˇ	表	
piǎo	ㄆㄧㄠˇ	縹	
miǎo	ㄇㄧㄠˇ	渺	
diǎo	ㄉㄧㄠˇ	屌	
tiǎo	ㄊㄧㄠˇ	窕	
niǎo	ㄋㄧㄠˇ	鳥	
liǎo	ㄌㄧㄠˇ	了	
jiǎo	ㄐㄧㄠˇ	腳	
qiǎo	ㄑㄧㄠˇ	巧	
xiǎo	ㄒㄧㄠˇ	小	
yǎo	ㄧㄠˇ	咬	
biào	ㄅㄧㄠˋ	鰾	
piào	ㄆㄧㄠˋ	票	
miào	ㄇㄧㄠˋ	妙	
diào	ㄉㄧㄠˋ	弔	
tiào	ㄊㄧㄠˋ	跳	
niào	ㄋㄧㄠˋ	尿	
liào	ㄌㄧㄠˋ	廖	
jiào	ㄐㄧㄠˋ	較	
qiào	ㄑㄧㄠˋ	鞘	
xiào	ㄒㄧㄠˋ	校	
yào	ㄧㄠˋ	要	
diū	ㄉㄧㄡ	丟	
niū	ㄋㄧㄡ	妞	
liū	ㄌㄧㄡ	溜	
jiū	ㄐㄧㄡ	糾	
qiū	ㄑㄧㄡ	丘	
xiū	ㄒㄧㄡ	休	
yōu	ㄧㄡ	悠	
niú	ㄋㄧㄡˊ	牛	
liú	ㄌㄧㄡˊ	流	
qiú	ㄑㄧㄡˊ	求	
yóu	ㄧㄡˊ	由	
niǔ	ㄋㄧㄡˇ	忸	
liǔ	ㄌㄧㄡˇ	柳	
jiǔ	ㄐㄧㄡˇ	久	
qiǔ	ㄑㄧㄡˇ	糗	
xiǔ	ㄒㄧㄡˇ	朽	
yǒu	ㄧㄡˇ	有	
miù	ㄇㄧㄡˋ	謬	
niù	ㄋㄧㄡˋ	拗	
liù	ㄌㄧㄡˋ	六	
jiù	ㄐㄧㄡˋ	疚	
xiù	ㄒㄧㄡˋ	秀	
yòu	ㄧㄡˋ	又	
biān	ㄅㄧㄢ	邊	
piān	ㄆㄧㄢ	偏	
diān	ㄉㄧㄢ	顛	
tiān	ㄊㄧㄢ	添	
niān	ㄋㄧㄢ	蔫	
jiān	ㄐㄧㄢ	肩	
qiān	ㄑㄧㄢ	鉛	
xiān	ㄒㄧㄢ	仙	
yān	ㄧㄢ	煙	
pián	ㄆㄧㄢˊ	駢	
mián	ㄇㄧㄢˊ	眠	
tián	ㄊㄧㄢˊ	田	
nián	ㄋㄧㄢˊ	年	
lián	ㄌㄧㄢˊ	連	
qián	ㄑㄧㄢˊ	乾	
xián	ㄒㄧㄢˊ	弦	
yán	ㄧㄢˊ	延	
biǎn	ㄅㄧㄢˇ	扁	
piǎn	ㄆㄧㄢˇ	諞	
miǎn	ㄇㄧㄢˇ	勉	
diǎn	ㄉㄧㄢˇ	典	
tiǎn	ㄊㄧㄢˇ	餂	
niǎn	ㄋㄧㄢˇ	碾	
liǎn	ㄌㄧㄢˇ	臉	
jiǎn	ㄐㄧㄢˇ	柬	
qiǎn	ㄑㄧㄢˇ	遣	
xiǎn	ㄒㄧㄢˇ	險	
yǎn	ㄧㄢˇ	眼	
biàn	ㄅㄧㄢˋ	弁	
piàn	ㄆㄧㄢˋ	片	
miàn	ㄇㄧㄢˋ	面	
diàn	ㄉㄧㄢˋ	店	
tiàn	ㄊㄧㄢˋ	瑱	
niàn	ㄋㄧㄢˋ	念	
liàn	ㄌㄧㄢˋ	練	
jiàn	ㄐㄧㄢˋ	件	
qiàn	ㄑㄧㄢˋ	欠	
xiàn	ㄒㄧㄢˋ	現	
yàn	ㄧㄢˋ	燕	
bīn	ㄅㄧㄣ	賓	
pīn	ㄆㄧㄣ	姘	
jīn	ㄐㄧㄣ	今	
qīn	ㄑㄧㄣ	侵	
xīn	ㄒㄧㄣ	欣	
yīn	ㄧㄣ	因	
pín	ㄆㄧㄣˊ	貧	
mín	ㄇㄧㄣˊ	民	
nín	ㄋㄧㄣˊ	您	
lín	ㄌㄧㄣˊ	林	
qín	ㄑㄧㄣˊ	琴	
xín	ㄒㄧㄣˊ	尋	
yín	ㄧㄣˊ	銀	
pǐn	ㄆㄧㄣˇ	品	
mǐn	ㄇㄧㄣˇ	敏	
lǐn	ㄌㄧㄣˇ	懍	
jǐn	ㄐㄧㄣˇ	謹	
qǐn	ㄑㄧㄣˇ	寢	
xǐn	ㄒㄧㄣˇ	伈	
yǐn	ㄧㄣˇ	引	
bìn	ㄅㄧㄣˋ	儐	
pìn	ㄆㄧㄣˋ	聘	
lìn	ㄌㄧㄣˋ	吝	
jìn	ㄐㄧㄣˋ	近	
qìn	ㄑㄧㄣˋ	沁	
xìn	ㄒㄧㄣˋ	信	
yìn	ㄧㄣˋ	印	
jiāng	ㄐㄧㄤ	江	
qiāng	ㄑㄧㄤ	羌	
xiāng	ㄒㄧㄤ	香	
yāng	ㄧㄤ	央	
niáng	ㄋㄧㄤˊ	娘	
liáng	ㄌㄧㄤˊ	良	
qiáng	ㄑㄧㄤˊ	強	
xiáng	ㄒㄧㄤˊ	祥	
yáng	ㄧㄤˊ	羊	
liǎng	ㄌㄧㄤˇ	兩	
jiǎng	ㄐㄧㄤˇ	講	
qiǎng	ㄑㄧㄤˇ	搶	
xiǎng	ㄒㄧㄤˇ	享	
yǎng	ㄧㄤˇ	仰	
niàng	ㄋㄧㄤˋ	釀	
liàng	ㄌㄧㄤˋ	亮	
jiàng	ㄐㄧㄤˋ	降	
qiàng	ㄑㄧㄤˋ	嗆	
xiàng	ㄒㄧㄤˋ	向	
yàng	ㄧㄤˋ	樣	
bīng	ㄅㄧㄥ	冰	
pīng	ㄆㄧㄥ	乒	
dīng	ㄉㄧㄥ	丁	
tīng	ㄊㄧㄥ	聽	
līng	ㄌㄧㄥ	拎	
jīng	ㄐㄧㄥ	京	
qīng	ㄑㄧㄥ	輕	
xīng	ㄒㄧㄥ	興	
yīng	ㄧㄥ	英	
píng	ㄆㄧㄥˊ	平	
míng	ㄇㄧㄥˊ	明	
tíng	ㄊㄧㄥˊ	廷	
níng	ㄋㄧㄥˊ	寧	
líng	ㄌㄧㄥˊ	伶	
qíng	ㄑㄧㄥˊ	情	
xíng	ㄒㄧㄥˊ	形	
yíng	ㄧㄥˊ	迎	
bǐng	ㄅㄧㄥˇ	丙	
mǐng	ㄇㄧㄥˇ	茗	
dǐng	ㄉㄧㄥˇ	頂	
tǐng	ㄊㄧㄥˇ	挺	
nǐng	ㄋㄧㄥˇ	擰	
lǐng	ㄌㄧㄥˇ	領	
jǐng	ㄐㄧㄥˇ	景	
qǐng	ㄑㄧㄥˇ	請	
xǐng	ㄒㄧㄥˇ	醒	
yǐng	ㄧㄥˇ	影	
bìng	ㄅㄧㄥˋ	併	
pìng	ㄆㄧㄥˋ	聘	
mìng	ㄇㄧㄥˋ	命	
dìng	ㄉㄧㄥˋ	定	
tìng	ㄊㄧㄥˋ	聽	
nìng	ㄋㄧㄥˋ	佞	
lìng	ㄌㄧㄥˋ	另	
jìng	ㄐㄧㄥˋ	竟	
qìng	ㄑㄧㄥˋ	慶	
xìng	ㄒㄧㄥˋ	幸	
yìng	ㄧㄥˋ	應	
bū	ㄅㄨ	逋	
pū	ㄆㄨ	鋪	
fū	ㄈㄨ	夫	
dū	ㄉㄨ	都	
tū	ㄊㄨ	禿	
lū	ㄌㄨ	嚕	
gū	ㄍㄨ	姑	
kū	ㄎㄨ	枯	
hū	ㄏㄨ	乎	
zhū	ㄓㄨ	朱	
chū	ㄔㄨ	初	
shū	ㄕㄨ	舒	
zū	ㄗㄨ	租	
cū	ㄘㄨ	粗	
sū	ㄙㄨ	蘇	
wū	ㄨ	屋	
bú	ㄅㄨˊ	醭	
pú	ㄆㄨˊ	匍	
mú	ㄇㄨˊ	模	
fú	ㄈㄨˊ	扶	
dú	ㄉㄨˊ	獨	
tú	ㄊㄨˊ	途	
nú	ㄋㄨˊ	奴	
lú	ㄌㄨˊ	廬	
gú	ㄍㄨˊ	骨	
hú	ㄏㄨˊ	胡	
zhú	ㄓㄨˊ	竹	
chú	ㄔㄨˊ	除	
shú	ㄕㄨˊ	淑	
rú	ㄖㄨˊ	如	
zú	ㄗㄨˊ	足	
cú	ㄘㄨˊ	徂	
sú	ㄙㄨˊ	俗	
wú	ㄨˊ	吾	
bǔ	ㄅㄨˇ	補	
pǔ	ㄆㄨˇ	普	
mǔ	ㄇㄨˇ	母	
fǔ	ㄈㄨˇ	府	
dǔ	ㄉㄨˇ	篤	
tǔ	ㄊㄨˇ	吐	
nǔ	ㄋㄨˇ	努	
lǔ	ㄌㄨˇ	魯	
gǔ	ㄍㄨˇ	古	
kǔ	ㄎㄨˇ	苦	
hǔ	ㄏㄨˇ	虎	
zhǔ	ㄓㄨˇ	主	
chǔ	ㄔㄨˇ	楚	
shǔ	ㄕㄨˇ	黍	
rǔ	ㄖㄨˇ	乳	
zǔ	ㄗㄨˇ	阻	
wǔ	ㄨˇ	午	
bù	ㄅㄨˋ	布	
pù	ㄆㄨˋ	鋪	
mù	ㄇㄨˋ	墓	
fù	ㄈㄨˋ	付	
dù	ㄉㄨˋ	杜	
tù	ㄊㄨˋ	兔	
nù	ㄋㄨˋ	怒	
lù	ㄌㄨˋ	路	
gù	ㄍㄨˋ	故	
kù	ㄎㄨˋ	庫	
hù	ㄏㄨˋ	戶	
zhù	ㄓㄨˋ	住	
chù	ㄔㄨˋ	觸	
shù	ㄕㄨˋ	樹	
rù	ㄖㄨˋ	入	
zù	ㄗㄨˋ	駔	
cù	ㄘㄨˋ	醋	
sù	ㄙㄨˋ	素	
wù	ㄨˋ	誤	
guā	ㄍㄨㄚ	瓜	
kuā	ㄎㄨㄚ	誇	
huā	ㄏㄨㄚ	花	
zhuā	ㄓㄨㄚ	抓	
chuā	ㄔㄨㄚ	欻	
shuā	ㄕㄨㄚ	刷	
wā	ㄨㄚ	蛙	
huá	ㄏㄨㄚˊ	華	
wá	ㄨㄚˊ	娃	
guǎ	ㄍㄨㄚˇ	寡	
kuǎ	ㄎㄨㄚˇ	侉	
zhuǎ	ㄓㄨㄚˇ	爪	
shuǎ	ㄕㄨㄚˇ	耍	
wǎ	ㄨㄚˇ	瓦	
guà	ㄍㄨㄚˋ	卦	
kuà	ㄎㄨㄚˋ	胯	
huà	ㄏㄨㄚˋ	化	
wà	ㄨㄚˋ	襪	
duō	ㄉㄨㄛ	多	
tuō	ㄊㄨㄛ	托	
luō	ㄌㄨㄛ	囉	
guō	ㄍㄨㄛ	郭	
huō	ㄏㄨㄛ	豁	
zhuō	ㄓㄨㄛ	捉	
chuō	ㄔㄨㄛ	戳	
shuō	ㄕㄨㄛ	說	
zuō	ㄗㄨㄛ	嘬	
cuō	ㄘㄨㄛ	磋	
suō	ㄙㄨㄛ	唆	
wō	ㄨㄛ	窩	
duó	ㄉㄨㄛˊ	奪	
tuó	ㄊㄨㄛˊ	駝	
nuó	ㄋㄨㄛˊ	挪	
luó	ㄌㄨㄛˊ	螺	
guó	ㄍㄨㄛˊ	國	
huó	ㄏㄨㄛˊ	活	
zhuó	ㄓㄨㄛˊ	濁	
ruó	ㄖㄨㄛˊ	挼	
zuó	ㄗㄨㄛˊ	昨	
cuó	ㄘㄨㄛˊ	矬	
suó	ㄙㄨㄛˊ	索	
duǒ	ㄉㄨㄛˇ	朵	
tuǒ	ㄊㄨㄛˇ	妥	
luǒ	ㄌㄨㄛˇ	裸	
guǒ	ㄍㄨㄛˇ	果	
huǒ	ㄏㄨㄛˇ	火	
zuǒ	ㄗㄨㄛˇ	左	
cuǒ	ㄘㄨㄛˇ	瑳	
suǒ	ㄙㄨㄛˇ	鎖	
wǒ	ㄨㄛˇ	我	
duò	ㄉㄨㄛˋ	舵	
tuò	ㄊㄨㄛˋ	拓	
nuò	ㄋㄨㄛˋ	諾	
luò	ㄌㄨㄛˋ	洛	
guò	ㄍㄨㄛˋ	過	
kuò	ㄎㄨㄛˋ	闊	
huò	ㄏㄨㄛˋ	或	
chuò	ㄔㄨㄛˋ	綽	
shuò	ㄕㄨㄛˋ	碩	
ruò	ㄖㄨㄛˋ	若	
zuò	ㄗㄨㄛˋ	坐	
cuò	ㄘㄨㄛˋ	錯	
wò	ㄨㄛˋ	臥	
guāi	ㄍㄨㄞ	乖	
kuāi	ㄎㄨㄞ	咼	
zhuāi	ㄓㄨㄞ	拽	
chuāi	ㄔㄨㄞ	搋	
shuāi	ㄕㄨㄞ	衰	
wāi	ㄨㄞ	歪	
huái	ㄏㄨㄞˊ	徊	
chuái	ㄔㄨㄞˊ	膗	
guǎi	ㄍㄨㄞˇ	拐	
kuǎi	ㄎㄨㄞˇ	蒯	
zhuǎi	ㄓㄨㄞˇ	跩	
chuǎi	ㄔㄨㄞˇ	揣	
shuǎi	ㄕㄨㄞˇ	甩	
wǎi	ㄨㄞˇ	歪*	原文件作“舀”
guài	ㄍㄨㄞˋ	怪	
kuài	ㄎㄨㄞˋ	快	
huài	ㄏㄨㄞˋ	壞	
zhuài	ㄓㄨㄞˋ	拽	
chuài	ㄔㄨㄞˋ	踹	
shuài	ㄕㄨㄞˋ	帥	
wài	ㄨㄞˋ	外	
duī	ㄉㄨㄟ	堆	
tuī	ㄊㄨㄟ	推	
guī	ㄍㄨㄟ	歸	
kuī	ㄎㄨㄟ	虧	
huī	ㄏㄨㄟ	灰	
zhuī	ㄓㄨㄟ	追	
chuī	ㄔㄨㄟ	吹	
zuī	ㄗㄨㄟ	脧	
cuī	ㄘㄨㄟ	崔	
suī	ㄙㄨㄟ	雖	
wēi	ㄨㄟ	威	
tuí	ㄊㄨㄟˊ	頹	
kuí	ㄎㄨㄟˊ	葵	
huí	ㄏㄨㄟˊ	回	
chuí	ㄔㄨㄟˊ	垂	
shuí	ㄕㄨㄟˊ	誰	
ruí	ㄖㄨㄟˊ	蕤	
suí	ㄙㄨㄟˊ	隨	
wéi	ㄨㄟˊ	韋	
tuǐ	ㄊㄨㄟˇ	腿	
guǐ	ㄍㄨㄟˇ	軌	
kuǐ	ㄎㄨㄟˇ	傀	
huǐ	ㄏㄨㄟˇ	毀	
shuǐ	ㄕㄨㄟˇ	水	
ruǐ	ㄖㄨㄟˇ	蕊	
zuǐ	ㄗㄨㄟˇ	嘴	
cuǐ	ㄘㄨㄟˇ	璀	
suǐ	ㄙㄨㄟˇ	髓	
wěi	ㄨㄟˇ	偉	
duì	ㄉㄨㄟˋ	對	
tuì	ㄊㄨㄟˋ	退	
guì	ㄍㄨㄟˋ	桂	
kuì	ㄎㄨㄟˋ	愧	
huì	ㄏㄨㄟˋ	惠	
zhuì	ㄓㄨㄟˋ	綴	
chuì	ㄔㄨㄟˋ	吹	
shuì	ㄕㄨㄟˋ	稅	
ruì	ㄖㄨㄟˋ	銳	
zuì	ㄗㄨㄟˋ	罪	
cuì	ㄘㄨㄟˋ	粹	
suì	ㄙㄨㄟˋ	歲	
wèi	ㄨㄟˋ	未	
duān	ㄉㄨㄢ	端	
tuān	ㄊㄨㄢ	湍	
guān	ㄍㄨㄢ	官	
kuān	ㄎㄨㄢ	寬	
huān	ㄏㄨㄢ	歡	
zhuān	ㄓㄨㄢ	專	
chuān	ㄔㄨㄢ	川	
shuān	ㄕㄨㄢ	拴	
zuān	ㄗㄨㄢ	鑽	
cuān	ㄘㄨㄢ	攛	
suān	ㄙㄨㄢ	酸	
wān	ㄨㄢ	蜿	
tuán	ㄊㄨㄢˊ	團	
luán	ㄌㄨㄢˊ	鸞	
huán	ㄏㄨㄢˊ	還	
chuán	ㄔㄨㄢˊ	船	
ruán	ㄖㄨㄢˊ	堧	
cuán	ㄘㄨㄢˊ	攢	
wán	ㄨㄢˊ	玩	
duǎn	ㄉㄨㄢˇ	短	
tuǎn	ㄊㄨㄢˇ	畽	
nuǎn	ㄋㄨㄢˇ	暖	
luǎn	ㄌㄨㄢˇ	卵	
guǎn	ㄍㄨㄢˇ	管	
kuǎn	ㄎㄨㄢˇ	款	
huǎn	ㄏㄨㄢˇ	緩	
zhuǎn	ㄓㄨㄢˇ	轉	
chuǎn	ㄔㄨㄢˇ	喘	
ruǎn	ㄖㄨㄢˇ	軟	
zuǎn	ㄗㄨㄢˇ	纂	
wǎn	ㄨㄢˇ	晚	
duàn	ㄉㄨㄢˋ	段	
tuàn	ㄊㄨㄢˋ	彖	
luàn	ㄌㄨㄢˋ	亂	
guàn	ㄍㄨㄢˋ	灌	
huàn	ㄏㄨㄢˋ	幻	
zhuàn	ㄓㄨㄢˋ	賺	
chuàn	ㄔㄨㄢˋ	串	
shuàn	ㄕㄨㄢˋ	涮	
zuàn	ㄗㄨㄢˋ	鑽	
cuàn	ㄘㄨㄢˋ	篡	
suàn	ㄙㄨㄢˋ	算	
wàn	ㄨㄢˋ	萬	
dūn	ㄉㄨㄣ	敦	
tūn	ㄊㄨㄣ	吞	
lūn	ㄌㄨㄣ	掄	
kūn	ㄎㄨㄣ	昆	
hūn	ㄏㄨㄣ	昏	
zhūn	ㄓㄨㄣ	屯	
chūn	ㄔㄨㄣ	春	
zūn	ㄗㄨㄣ	尊	
cūn	ㄘㄨㄣ	村	
sūn	ㄙㄨㄣ	孫	
wēn	ㄨㄣ	溫	
tún	ㄊㄨㄣˊ	屯	
lún	ㄌㄨㄣˊ	倫	
hún	ㄏㄨㄣˊ	魂	
chún	ㄔㄨㄣˊ	脣	
rún	ㄖㄨㄣˊ	犉	
cún	ㄘㄨㄣˊ	存	
wén	ㄨㄣˊ	文	
dǔn	ㄉㄨㄣˇ	盹	
tǔn	ㄊㄨㄣˇ	汆	
gǔn	ㄍㄨㄣˇ	滾	
kǔn	ㄎㄨㄣˇ	捆	
hǔn	ㄏㄨㄣˇ	混	
zhǔn	ㄓㄨㄣˇ	準	
chǔn	ㄔㄨㄣˇ	蠢	
shǔn	ㄕㄨㄣˇ	盾	
zǔn	ㄗㄨㄣˇ	撙	
cǔn	ㄘㄨㄣˇ	忖	
sǔn	ㄙㄨㄣˇ	筍	
wěn	ㄨㄣˇ	穩	
dùn	ㄉㄨㄣˋ	遁	
tùn	ㄊㄨㄣˋ	褪	
lùn	ㄌㄨㄣˋ	論	
gùn	ㄍㄨㄣˋ	棍	
kùn	ㄎㄨㄣˋ	困	
hùn	ㄏㄨㄣˋ	渾	
shùn	ㄕㄨㄣˋ	舜	
rùn	ㄖㄨㄣˋ	閏	
cùn	ㄘㄨㄣˋ	寸	
sùn	ㄙㄨㄣˋ	巽	
wèn	ㄨㄣˋ	問	
guāng	ㄍㄨㄤ	光	
kuāng	ㄎㄨㄤ	筐	
huāng	ㄏㄨㄤ	荒	
zhuāng	ㄓㄨㄤ	莊	
chuāng	ㄔㄨㄤ	窗	
shuāng	ㄕㄨㄤ	雙	
wāng	ㄨㄤ	汪	
kuáng	ㄎㄨㄤˊ	狂	
huáng	ㄏㄨㄤˊ	皇	
chuáng	ㄔㄨㄤˊ	床	
wáng	ㄨㄤˊ	王	
guǎng	ㄍㄨㄤˇ	廣	
huǎng	ㄏㄨㄤˇ	恍	
zhuǎng	ㄓㄨㄤˇ	奘	
chuǎng	ㄔㄨㄤˇ	闖	
shuǎng	ㄕㄨㄤˇ	爽	
wǎng	ㄨㄤˇ	往	
guàng	ㄍㄨㄤˋ	逛	
kuàng	ㄎㄨㄤˋ	況	
huàng	ㄏㄨㄤˋ	晃	
zhuàng	ㄓㄨㄤˋ	壯	
chuàng	ㄔㄨㄤˋ	創	
wàng	ㄨㄤˋ	望	
dōng	ㄉㄨㄥ	冬	
tōng	ㄊㄨㄥ	通	
gōng	ㄍㄨㄥ	工	
kōng	ㄎㄨㄥ	空	
hōng	ㄏㄨㄥ	烘	
zhōng	ㄓㄨㄥ	中	
chōng	ㄔㄨㄥ	沖	
zōng	ㄗㄨㄥ	宗	
cōng	ㄘㄨㄥ	匆	
sōng	ㄙㄨㄥ	松	
wēng	ㄨㄥ	翁	
tóng	ㄊㄨㄥˊ	同	
nóng	ㄋㄨㄥˊ	農	
lóng	ㄌㄨㄥˊ	隆	
hóng	ㄏㄨㄥˊ	紅	
chóng	ㄔㄨㄥˊ	蟲	
róng	ㄖㄨㄥˊ	戎	
cóng	ㄘㄨㄥˊ	從	
sóng	ㄙㄨㄥˊ	悚	
dǒng	ㄉㄨㄥˇ	董	
tǒng	ㄊㄨㄥˇ	統	
lǒng	ㄌㄨㄥˇ	攏	
gǒng	ㄍㄨㄥˇ	拱	
kǒng	ㄎㄨㄥˇ	孔	
hǒng	ㄏㄨㄥˇ	哄	
zhǒng	ㄓㄨㄥˇ	種	
chǒng	ㄔㄨㄥˇ	寵	
rǒng	ㄖㄨㄥˇ	冗	
zǒng	ㄗㄨㄥˇ	總	
sǒng	ㄙㄨㄥˇ	竦	
wěng	ㄨㄥˇ	蓊	
dòng	ㄉㄨㄥˋ	洞	
tòng	ㄊㄨㄥˋ	痛	
nòng	ㄋㄨㄥˋ	弄	
lòng	ㄌㄨㄥˋ	衖	
gòng	ㄍㄨㄥˋ	共	
kòng	ㄎㄨㄥˋ	控	
hòng	ㄏㄨㄥˋ	鬨	
zhòng	ㄓㄨㄥˋ	重	
chòng	ㄔㄨㄥˋ	銃	
zòng	ㄗㄨㄥˋ	縱	
sòng	ㄙㄨㄥˋ	送	
wèng	ㄨㄥˋ	甕	
jū	ㄐㄩ	居	
qū	ㄑㄩ	區	
xū	ㄒㄩ	虛	
yū	ㄩ	迂	
lǘ	ㄌㄩˊ	驢	
jú	ㄐㄩˊ	局	
qú	ㄑㄩˊ	渠	
xú	ㄒㄩˊ	徐	
yú	ㄩˊ	於	
nǚ	ㄋㄩˇ	女	
lǚ	ㄌㄩˇ	呂	
jǔ	ㄐㄩˇ	舉	
qǔ	ㄑㄩˇ	取	
xǔ	ㄒㄩˇ	許	
yǔ	ㄩˇ	羽	
nǜ	ㄋㄩˋ	沑*	原文件作“忸”
lǜ	ㄌㄩˋ	律	
jù	ㄐㄩˋ	巨	
qù	ㄑㄩˋ	去	
xù	ㄒㄩˋ	序	
yù	ㄩˋ	遇	
juē	ㄐㄩㄝ	嗟	
quē	ㄑㄩㄝ	缺	
xuē	ㄒㄩㄝ	靴	
yuē	ㄩㄝ	曰	
jué	ㄐㄩㄝˊ	決	
qué	ㄑㄩㄝˊ	瘸	
xué	ㄒㄩㄝˊ	學	
juě	ㄐㄩㄝˇ	蹶	
xuě	ㄒㄩㄝˇ	雪	
nüè	ㄋㄩㄝˋ	虐	
lüè	ㄌㄩㄝˋ	略	
què	ㄑㄩㄝˋ	卻	
xuè	ㄒㄩㄝˋ	穴	
yuè	ㄩㄝˋ	閱	
juān	ㄐㄩㄢ	捐	
quān	ㄑㄩㄢ	圈	
xuān	ㄒㄩㄢ	宣	
yuān	ㄩㄢ	冤	
lüán	ㄌㄩㄢˊ	孿	
quán	ㄑㄩㄢˊ	拳	
xuán	ㄒㄩㄢˊ	玄	
yuán	ㄩㄢˊ	元	
lüǎn	ㄌㄩㄢˇ	孌	
juǎn	ㄐㄩㄢˇ	捲	
quǎn	ㄑㄩㄢˇ	犬	
xuǎn	ㄒㄩㄢˇ	選	
yuǎn	ㄩㄢˇ	遠	
juàn	ㄐㄩㄢˋ	卷	
quàn	ㄑㄩㄢˋ	券	
xuàn	ㄒㄩㄢˋ	炫	
yuàn	ㄩㄢˋ	院	
jūn	ㄐㄩㄣ	均	
qūn	ㄑㄩㄣ	逡	
xūn	ㄒㄩㄣ	薰	
yūn	ㄩㄣ	暈	
qún	ㄑㄩㄣˊ	群	
xún	ㄒㄩㄣˊ	循	
yún	ㄩㄣˊ	云	
jǔn	ㄐㄩㄣˇ	窘	
yǔn	ㄩㄣˇ	允	
jùn	ㄐㄩㄣˋ	菌	
xùn	ㄒㄩㄣˋ	訓	
yùn	ㄩㄣˋ	運	
jiōng	ㄐㄩㄥ	坰	
qiōng	ㄑㄩㄥ	穹	
xiōng	ㄒㄩㄥ	凶	
yōng	ㄩㄥ	庸	
qióng	ㄑㄩㄥˊ	窮	
xióng	ㄒㄩㄥˊ	熊	
yóng	ㄩㄥˊ	喁	
jiǒng	ㄐㄩㄥˇ	炯	
yǒng	ㄩㄥˇ	永	
xiòng	ㄒㄩㄥˋ	敻	
yòng	ㄩㄥˋ	用	
