# 新华字典（第12版）：汉语拼音音节索引
# 共416个音节。
# 每一个音节的后面举一个例字，代表该音节。页码略。
#
# 拼音	例字

a	啊
ai	哀
an	安
ang	肮
ao	熬
ba	八
bai	白
ban	班
bang	帮
bao	包
bei	杯
ben	奔
beng	崩
bi	逼
bian	边
biao	标
bie	别
bin	宾
bing	兵
bo	玻
bu	不
ca	擦
cai	猜
can	餐
cang	仓
cao	操
ce	策
cen	岑
ceng	层
cha	插
chai	拆
chan	搀
chang	昌
chao	超
che	车
chen	尘
cheng	称
chi	吃
chong	充
chou	抽
chu	初
chua	欻
chuai	揣
chuan	川
chuang	窗
chui	吹
chun	春
chuo	戳
ci	词
cong	聪
cou	凑
cu	粗
cuan	撺
cui	崔
cun	村
cuo	搓
da	搭
dai	呆
dan	丹
dang	当
dao	刀
de	德
dei	得
den	扽
deng	登
di	低
dia	嗲
dian	颠
diao	刁
die	爹
ding	丁
diu	丢
dong	东
dou	兜
du	都
duan	端
dui	堆
dun	吨
duo	多
e	鹅
ê	欸
ei	㗒
en	恩
eng	鞥
er	儿
fa	发
fan	帆
fang	方
fei	非
fen	分
feng	风
fo	佛
fou	否
fu	夫
ga	嘎
gai	该
gan	干
gang	钢
gao	高
ge	哥
gei	给
gen	根
geng	耕
gong	工
gou	沟
gu	姑
gua	瓜
guai	乖
guan	关
guang	光
gui	归
gun	棍
guo	锅
ha	哈
hai	孩
han	含
hang	杭
hao	蒿
he	喝
hei	黑
hen	痕
heng	恒
hm	噷
hng	哼
hong	烘
hou	喉
hu	呼
hua	花
huai	怀
huan	欢
huang	荒
hui	灰
hun	昏
huo	活
ji	机
jia	加
jian	尖
jiang	江
jiao	交
jie	阶
jin	今
jing	京
jiong	迥
jiu	究
ju	居
juan	捐
jue	决
jun	军
ka	咖
kai	开
kan	刊
kang	康
kao	考
ke	科
kei	剋
ken	肯
keng	坑
kong	空
kou	抠
ku	枯
kua	夸
kuai	快
kuan	宽
kuang	筐
kui	亏
kun	昆
kuo	阔
la	拉
lai	来
lan	兰
lang	狼
lao	捞
le	勒
lei	类
leng	冷
li	里
lia	俩
lian	连
liang	良
liao	疗
lie	列
lin	林
ling	玲
liu	留
lo	咯
long	龙
lou	搂
lu	卢
lü	吕
luan	乱
lüe	略
lun	抡
luo	罗
m	呣
ma	妈
mai	埋
man	蛮
mang	忙
mao	猫
me	么
mei	眉
men	门
meng	蒙
mi	迷
mian	面
miao	苗
mie	灭
min	民
ming	明
miu	谬
mo	摸
mou	谋
mu	木
n	嗯
na	那
nai	乃
nan	男
nang	囊
nao	闹
ne	讷
nei	内
nen	嫩
neng	能
ng	嗯
ni	泥
nian	年
niang	娘
niao	鸟
nie	捏
nin	您
ning	宁
niu	牛
nong	农
nou	耨
nu	奴
nü	女
nuan	暖
nüe	虐
nuo	挪
o	哦
ou	欧
pa	怕
pai	拍
pan	潘
pang	旁
pao	抛
pei	胚
pen	喷
peng	烹
pi	批
pian	偏
piao	飘
pie	撇
pin	拼
ping	乒
po	坡
pou	剖
pu	扑
qi	七
qia	恰
qian	千
qiang	枪
qiao	敲
qie	切
qin	亲
qing	青
qiong	穷
qiu	秋
qu	区
quan	圈
que	缺
qun	群
ran	然
rang	嚷
rao	饶
re	热
ren	人
reng	扔
ri	日
rong	容
rou	柔
ru	如
rua	挼
ruan	软
rui	锐
run	润
ruo	弱
sa	撒
sai	赛
san	三
sang	桑
sao	搔
se	涩
sen	森
seng	僧
sha	杀
shai	筛
shan	山
shang	商
shao	烧
she	奢
shei	谁
shen	深
sheng	升
shi	诗
shou	收
shu	书
shua	刷
shuai	衰
shuan	闩
shuang	双
shui	水
shun	顺
shuo	说
si	思
song	松
sou	搜
su	苏
suan	酸
sui	虽
sun	孙
suo	梭
ta	他
tai	胎
tan	贪
tang	汤
tao	涛
te	特
teng	疼
ti	梯
tian	天
tiao	挑
tie	贴
ting	听
tong	通
tou	偷
tu	突
tuan	团
tui	推
tun	吞
tuo	拖
wa	挖
wai	歪
wan	弯
wang	汪
wei	危
wen	温
weng	翁
wo	窝
wu	污
xi	西
xia	虾
xian	先
xiang	香
xiao	消
xie	些
xin	心
xing	星
xiong	兄
xiu	休
xu	需
xuan	宣
xue	靴
xun	勋
ya	呀
yan	烟
yang	央
yao	腰
ye	爷
yi	一
yin	音
ying	英
yo	唷
yong	拥
you	优
yu	于
yuan	渊
yue	约
yun	云
za	匝
zai	栽
zan	赞
zang	脏
zao	遭
ze	则
zei	贼
zen	怎
zeng	增
zha	扎
zhai	摘
zhan	沾
zhang	章
zhao	招
zhe	遮
zhei	这
zhen	针
zheng	征
zhi	之
zhong	忠
zhou	州
zhu	朱
zhua	抓
zhuai	拽
zhuan	专
zhuang	庄
zhui	追
zhun	准
zhuo	捉
zi	资
zong	宗
zou	邹
zu	租
zuan	钻
zui	最
zun	尊
zuo	作
