# 汉典-字典拼音索引和对照
# 合计共422个音节（两表共有406个）
#
# 字典拼音索引 https://www.zdic.net/zd/py/
# 汉语拼音与其他拼音系统对照表 https://www.zdic.net/ts/fulu/2019/05/18.html
#
# 备注：
# 字典拼音索引：共415个音节；
# 汉语拼音与其他拼音系统对照表：共413个音节。
# 只在索引中的包括9个: dia, n, hng, ng, kei, yo, rua, hm, m；
# 只在对照表的包括7个: diang, shong, lün, nun, nia, lüan, sei。
#
# 拼音	注音	例字

a	ㄚ	啊
ai	ㄞ	哀
an	ㄢ	安
ang	ㄤ	肮
ao	ㄠ	熬
ba	ㄅㄚ	八
bai	ㄅㄞ	白
ban	ㄅㄢ	班
bang	ㄅㄤ	帮
bao	ㄅㄠ	包
bei	ㄅㄟ	杯
ben	ㄅㄣ	奔
beng	ㄅㄥ	崩
bi	ㄅㄧ	逼
bian	ㄅㄧㄢ	边
biao	ㄅㄧㄠ	标
bie	ㄅㄧㄝ	别
bin	ㄅㄧㄣ	宾
bing	ㄅㄧㄥ	兵
bo	ㄅㄛ	玻
bu	ㄅㄨ	不
ca	ㄘㄚ	擦
cai	ㄘㄞ	猜
can	ㄘㄢ	餐
cang	ㄘㄤ	仓
cao	ㄘㄠ	操
ce	ㄘㄜ	策
cen	ㄘㄣ	岑
ceng	ㄘㄥ	层
cha	ㄔㄚ	插
chai	ㄔㄞ	拆
chan	ㄔㄢ	搀
chang	ㄔㄤ	昌
chao	ㄔㄠ	超
che	ㄔㄜ	车
chen	ㄔㄣ	尘
cheng	ㄔㄥ	称
chi	ㄔ	吃
chong	ㄔㄨㄥ	充
chou	ㄔㄡ	抽
chu	ㄔㄨ	初
chua	ㄔㄨㄚ	欻
chuai	ㄔㄨㄞ	揣
chuan	ㄔㄨㄢ	川
chuang	ㄔㄨㄤ	窗
chui	ㄔㄨㄟ	吹
chun	ㄔㄨㄣ	春
chuo	ㄔㄨㄛ	戳
ci	ㄘ	词
cong	ㄘㄨㄥ	聪
cou	ㄘㄡ	凑
cu	ㄘㄨ	粗
cuan	ㄘㄨㄢ	撺
cui	ㄘㄨㄟ	崔
cun	ㄘㄨㄣ	村
cuo	ㄘㄨㄛ	搓
da	ㄉㄚ	搭
dai	ㄉㄞ	呆
dan	ㄉㄢ	丹
dang	ㄉㄤ	当
dao	ㄉㄠ	刀
de	ㄉㄜ	德
dei	ㄉㄟ	得
den	ㄉㄣ	扽
deng	ㄉㄥ	登
di	ㄉㄧ	低
dia		嗲
dian	ㄉㄧㄢ	颠
diang	ㄉㄧㄤ	
diao	ㄉㄧㄠ	刁
die	ㄉㄧㄝ	爹
ding	ㄉㄧㄥ	丁
diu	ㄉㄧㄡ	丢
dong	ㄉㄨㄥ	东
dou	ㄉㄡ	兜
du	ㄉㄨ	都
duan	ㄉㄨㄢ	端
dui	ㄉㄨㄟ	堆
dun	ㄉㄨㄣ	吨
duo	ㄉㄨㄛ	多
e	ㄜ	鹅
ei	ㄟ	诶
en	ㄣ	恩
eng	ㄥ	鞥
er	ㄦ	儿
fa	ㄈㄚ	发
fan	ㄈㄢ	帆
fang	ㄈㄤ	方
fei	ㄈㄟ	非
fen	ㄈㄣ	分
feng	ㄈㄥ	风
fo	ㄈㄛ	佛
fou	ㄈㄡ	否
fu	ㄈㄨ	夫
ga	ㄍㄚ	嘎
gai	ㄍㄞ	该
gan	ㄍㄢ	干
gang	ㄍㄤ	钢
gao	ㄍㄠ	高
ge	ㄍㄜ	哥
gei	ㄍㄟ	给
gen	ㄍㄣ	根
geng	ㄍㄥ	耕
gong	ㄍㄨㄥ	工
gou	ㄍㄡ	沟
gu	ㄍㄨ	姑
gua	ㄍㄨㄚ	瓜
guai	ㄍㄨㄞ	乖
guan	ㄍㄨㄢ	关
guang	ㄍㄨㄤ	光
gui	ㄍㄨㄟ	归
gun	ㄍㄨㄣ	棍
guo	ㄍㄨㄛ	锅
ha	ㄏㄚ	哈
hai	ㄏㄞ	孩
han	ㄏㄢ	含
hang	ㄏㄤ	杭
hao	ㄏㄠ	蒿
he	ㄏㄜ	喝
hei	ㄏㄟ	黑
hen	ㄏㄣ	痕
heng	ㄏㄥ	恒
hm		噷
hng		哼
hong	ㄏㄨㄥ	烘
hou	ㄏㄡ	喉
hu	ㄏㄨ	呼
hua	ㄏㄨㄚ	花
huai	ㄏㄨㄞ	怀
huan	ㄏㄨㄢ	欢
huang	ㄏㄨㄤ	荒
hui	ㄏㄨㄟ	灰
hun	ㄏㄨㄣ	昏
huo	ㄏㄨㄛ	活
ji	ㄐㄧ	机
jia	ㄐㄧㄚ	加
jian	ㄐㄧㄢ	尖
jiang	ㄐㄧㄤ	江
jiao	ㄐㄧㄠ	交
jie	ㄐㄧㄝ	阶
jin	ㄐㄧㄣ	今
jing	ㄐㄧㄥ	京
jiong	ㄐㄩㄥ	迥
jiu	ㄐㄧㄡ	究
ju	ㄐㄩ	居
juan	ㄐㄩㄢ	捐
jue	ㄐㄩㄝ	决
jun	ㄐㄩㄣ	军
ka	ㄎㄚ	咖
kai	ㄎㄞ	开
kan	ㄎㄢ	刊
kang	ㄎㄤ	康
kao	ㄎㄠ	考
ke	ㄎㄜ	科
kei		剋
ken	ㄎㄣ	肯
keng	ㄎㄥ	坑
kong	ㄎㄨㄥ	空
kou	ㄎㄡ	抠
ku	ㄎㄨ	枯
kua	ㄎㄨㄚ	夸
kuai	ㄎㄨㄞ	快
kuan	ㄎㄨㄢ	宽
kuang	ㄎㄨㄤ	筐
kui	ㄎㄨㄟ	亏
kun	ㄎㄨㄣ	昆
kuo	ㄎㄨㄛ	阔
la	ㄌㄚ	拉
lai	ㄌㄞ	来
lan	ㄌㄢ	兰
lang	ㄌㄤ	狼
lao	ㄌㄠ	捞
le	ㄌㄜ	勒
lei	ㄌㄟ	类
leng	ㄌㄥ	冷
li	ㄌㄧ	里
lia	ㄌㄧㄚ	俩
lian	ㄌㄧㄢ	连
liang	ㄌㄧㄤ	良
liao	ㄌㄧㄠ	疗
lie	ㄌㄧㄝ	列
lin	ㄌㄧㄣ	林
ling	ㄌㄧㄥ	玲
liu	ㄌㄧㄡ	留
lo	ㄌㄛ	咯
long	ㄌㄨㄥ	龙
lou	ㄌㄡ	搂
lu	ㄌㄨ	卢
lü	ㄌㄩ	吕
luan	ㄌㄨㄢ	乱
lüan	ㄌㄩㄢ	
lüe	ㄌㄩㄝ	略
lun	ㄌㄨㄣ	抡
lün	ㄌㄩㄣ	
luo	ㄌㄨㄛ	罗
m		呣
ma	ㄇㄚ	妈
mai	ㄇㄞ	埋
man	ㄇㄢ	蛮
mang	ㄇㄤ	忙
mao	ㄇㄠ	猫
me	ㄇㄜ	么
mei	ㄇㄟ	眉
men	ㄇㄣ	门
meng	ㄇㄥ	蒙
mi	ㄇㄧ	迷
mian	ㄇㄧㄢ	面
miao	ㄇㄧㄠ	苗
mie	ㄇㄧㄝ	灭
min	ㄇㄧㄣ	民
ming	ㄇㄧㄥ	明
miu	ㄇㄧㄡ	谬
mo	ㄇㄛ	摸
mou	ㄇㄡ	谋
mu	ㄇㄨ	木
n		嗯
na	ㄋㄚ	那
nai	ㄋㄞ	乃
nan	ㄋㄢ	男
nang	ㄋㄤ	囊
nao	ㄋㄠ	闹
ne	ㄋㄜ	讷
nei	ㄋㄟ	内
nen	ㄋㄣ	嫩
neng	ㄋㄥ	能
ng		嗯
ni	ㄋㄧ	泥
nia	ㄋㄧㄚ	
nian	ㄋㄧㄢ	年
niang	ㄋㄧㄤ	娘
niao	ㄋㄧㄠ	鸟
nie	ㄋㄧㄝ	捏
nin	ㄋㄧㄣ	您
ning	ㄋㄧㄥ	宁
niu	ㄋㄧㄡ	牛
nong	ㄋㄨㄥ	农
nou	ㄋㄡ	耨
nu	ㄋㄨ	奴
nuan	ㄋㄨㄢ	暖
nun	ㄋㄨㄣ	
nuo	ㄋㄨㄛ	挪
nü	ㄋㄩ	女
nüe	ㄋㄩㄝ	虐
o	ㄛ	哦
ou	ㄡ	欧
pa	ㄆㄚ	怕
pai	ㄆㄞ	拍
pan	ㄆㄢ	潘
pang	ㄆㄤ	旁
pao	ㄆㄠ	抛
pei	ㄆㄟ	胚
pen	ㄆㄣ	喷
peng	ㄆㄥ	烹
pi	ㄆㄧ	批
pian	ㄆㄧㄢ	偏
piao	ㄆㄧㄠ	飘
pie	ㄆㄧㄝ	撇
pin	ㄆㄧㄣ	拼
ping	ㄆㄧㄥ	乒
po	ㄆㄛ	坡
pou	ㄆㄡ	剖
pu	ㄆㄨ	扑
qi	ㄑㄧ	七
qia	ㄑㄧㄚ	恰
qian	ㄑㄧㄢ	千
qiang	ㄑㄧㄤ	枪
qiao	ㄑㄧㄠ	敲
qie	ㄑㄧㄝ	切
qin	ㄑㄧㄣ	亲
qing	ㄑㄧㄥ	青
qiong	ㄑㄩㄥ	穷
qiu	ㄑㄧㄡ	秋
qu	ㄑㄩ	区
quan	ㄑㄩㄢ	圈
que	ㄑㄩㄝ	缺
qun	ㄑㄩㄣ	群
ran	ㄖㄢ	然
rang	ㄖㄤ	嚷
rao	ㄖㄠ	饶
re	ㄖㄜ	热
ren	ㄖㄣ	人
reng	ㄖㄥ	扔
ri	ㄖ	日
rong	ㄖㄨㄥ	容
rou	ㄖㄡ	柔
ru	ㄖㄨ	如
rua		挼
ruan	ㄖㄨㄢ	软
rui	ㄖㄨㄟ	锐
run	ㄖㄨㄣ	润
ruo	ㄖㄨㄛ	弱
sa	ㄙㄚ	撒
sai	ㄙㄞ	赛
san	ㄙㄢ	三
sang	ㄙㄤ	桑
sao	ㄙㄠ	搔
se	ㄙㄜ	涩
sei	ㄙㄟ	
sen	ㄙㄣ	森
seng	ㄙㄥ	僧
sha	ㄕㄚ	杀
shai	ㄕㄞ	筛
shan	ㄕㄢ	山
shang	ㄕㄤ	商
shao	ㄕㄠ	烧
she	ㄕㄜ	奢
shei	ㄕㄟ	谁
shen	ㄕㄣ	深
sheng	ㄕㄥ	升
shi	ㄕ	诗
shong	ㄕㄨㄥ	
shou	ㄕㄡ	收
shu	ㄕㄨ	书
shua	ㄕㄨㄚ	刷
shuai	ㄕㄨㄞ	衰
shuan	ㄕㄨㄢ	闩
shuang	ㄕㄨㄤ	双
shui	ㄕㄨㄟ	水
shun	ㄕㄨㄣ	顺
shuo	ㄕㄨㄛ	说
si	ㄙ	思
song	ㄙㄨㄥ	松
sou	ㄙㄡ	搜
su	ㄙㄨ	苏
suan	ㄙㄨㄢ	酸
sui	ㄙㄨㄟ	虽
sun	ㄙㄨㄣ	孙
suo	ㄙㄨㄛ	梭
ta	ㄊㄚ	他
tai	ㄊㄞ	胎
tan	ㄊㄢ	贪
tang	ㄊㄤ	汤
tao	ㄊㄠ	涛
te	ㄊㄜ	特
teng	ㄊㄥ	疼
ti	ㄊㄧ	梯
tian	ㄊㄧㄢ	天
tiao	ㄊㄧㄠ	挑
tie	ㄊㄧㄝ	贴
ting	ㄊㄧㄥ	听
tong	ㄊㄨㄥ	通
tou	ㄊㄡ	偷
tu	ㄊㄨ	突
tuan	ㄊㄨㄢ	团
tui	ㄊㄨㄟ	推
tun	ㄊㄨㄣ	吞
tuo	ㄊㄨㄛ	拖
wa	ㄨㄚ	挖
wai	ㄨㄞ	歪
wan	ㄨㄢ	弯
wang	ㄨㄤ	汪
wei	ㄨㄟ	危
wen	ㄨㄣ	温
weng	ㄨㄥ	翁
wo	ㄨㄛ	窝
wu	ㄨ	污
xi	ㄒㄧ	西
xia	ㄒㄧㄚ	虾
xian	ㄒㄧㄢ	先
xiang	ㄒㄧㄤ	香
xiao	ㄒㄧㄠ	消
xie	ㄒㄧㄝ	些
xin	ㄒㄧㄣ	心
xing	ㄒㄧㄥ	星
xiong	ㄒㄩㄥ	兄
xiu	ㄒㄧㄡ	休
xu	ㄒㄩ	需
xuan	ㄒㄩㄢ	宣
xue	ㄒㄩㄝ	靴
xun	ㄒㄩㄣ	勋
ya	ㄧㄚ	呀
yan	ㄧㄢ	烟
yang	ㄧㄤ	央
yao	ㄧㄠ	腰
ye	ㄧㄝ	爷
yi	ㄧ	一
yin	ㄧㄣ	音
ying	ㄧㄥ	英
yo		唷
yong	ㄩㄥ	拥
you	ㄧㄡ	优
yu	ㄩ	于
yuan	ㄩㄢ	渊
yue	ㄩㄝ	约
yun	ㄩㄣ	云
za	ㄗㄚ	匝
zai	ㄗㄞ	栽
zan	ㄗㄢ	赞
zang	ㄗㄤ	脏
zao	ㄗㄠ	遭
ze	ㄗㄜ	则
zei	ㄗㄟ	贼
zen	ㄗㄣ	怎
zeng	ㄗㄥ	增
zha	ㄓㄚ	扎
zhai	ㄓㄞ	摘
zhan	ㄓㄢ	沾
zhang	ㄓㄤ	章
zhao	ㄓㄠ	招
zhe	ㄓㄜ	遮
zhei	ㄓㄟ	这
zhen	ㄓㄣ	针
zheng	ㄓㄥ	征
zhi	ㄓ	之
zhong	ㄓㄨㄥ	忠
zhou	ㄓㄡ	州
zhu	ㄓㄨ	朱
zhua	ㄓㄨㄚ	抓
zhuai	ㄓㄨㄞ	拽
zhuan	ㄓㄨㄢ	专
zhuang	ㄓㄨㄤ	庄
zhui	ㄓㄨㄟ	追
zhun	ㄓㄨㄣ	准
zhuo	ㄓㄨㄛ	捉
zi	ㄗ	资
zong	ㄗㄨㄥ	宗
zou	ㄗㄡ	邹
zu	ㄗㄨ	租
zuan	ㄗㄨㄢ	钻
zui	ㄗㄨㄟ	最
zun	ㄗㄨㄣ	尊
zuo	ㄗㄨㄛ	作
